Land,Jahr,"Kinder bis unter 3 Jahren","Kinder von 3 bis unter 7 Jahren (ohne Schulkinder)",Kinder von 5 bis unter 14 Jahren (nur Schulkinder),"Kinder von 7 Jahren und älter (Nicht-schulkinder)",Insgesamt
Baden-Württemberg,2006,21193,344255,21981,508,387937
Baden-Württemberg,2007,26978,329244,22424,1088,379734
Baden-Württemberg,2008,32289,319740,24955,938,377922
Baden-Württemberg,2009,37538,316560,26812,1325,382235
Baden-Württemberg,2010,43711,310411,28240,1407,383769
Baden-Württemberg,2011,49392,309360,29135,1770,389657
Baden-Württemberg,2012,54272,305970,28941,1474,390657
Baden-Württemberg,2013,58805,306137,30231,944,396117
Baden-Württemberg,2014,66465,307285,28941,1591,404282
Baden-Württemberg,2015,68909,307462,29242,817,406430
Baden-Württemberg,2016,71936,312721,27603,1349,413609
Baden-Württemberg,2017,76748,318909,28236,570,424463
Baden-Württemberg,2018,79807,326105,26624,848,433384
Baden-Württemberg,2019,81695,335386,25581,1325,443987
Baden-Württemberg,2020,83100,344940,25775,562,454377
Baden-Württemberg,2021,79213,352162,24242,152,455769
Baden-Württemberg,2022,83087,363457,24586,6,471136
Baden-Württemberg,2023,85421,375055,23998,921,485395
Baden-Württemberg,2024,85513,378526,24033,773,488845
Bayern,2006,24281,362653,43291,3243,433468
Bayern,2007,31091,359299,51701,663,442754
Bayern,2008,37757,351627,58177,937,448498
Bayern,2009,45238,344776,63647,965,454626
Bayern,2010,53260,339538,67547,832,461177
Bayern,2011,59310,340393,69808,407,469918
Bayern,2012,66241,342710,72469,368,481788
Bayern,2013,72562,345101,74513,593,492769
Bayern,2014,81693,349735,76643,504,508575
Bayern,2015,85707,353189,80176,601,519673
Bayern,2016,88291,360769,83507,750,533317
Bayern,2017,92329,368638,87110,745,548822
Bayern,2018,95064,377754,88168,753,561739
Bayern,2019,100607,388388,89268,829,579092
Bayern,2020,104949,403084,90924,846,599803
Bayern,2021,104590,415666,88711,905,609872
Bayern,2022,111322,424475,92268,1039,629104
Bayern,2023,115974,432280,96283,1031,645568
Bayern,2024,117413,436208,99973,1089,654683
Berlin,2006,29437,76005,84,57,105583
Berlin,2007,31363,78524,62,38,109987
Berlin,2008,32732,80949,8,35,113724
Berlin,2009,34929,82525,3,62,117519
Berlin,2010,36408,84569,-,59,121036
Berlin,2011,36978,88153,-,59,125190
Berlin,2012,37725,91562,-,88,129375
Berlin,2013,39566,95119,-,91,134776
Berlin,2014,42632,98591,-,124,141347
Berlin,2015,44568,101813,-,202,146583
Berlin,2016,46331,105368,-,229,151928
Berlin,2017,47462,108914,-,338,156714
Berlin,2018,47557,112661,-,309,160527
Berlin,2019,47692,115242,-,553,163487
Berlin,2020,48329,118289,-,486,167104
Berlin,2021,48040,119954,-,476,168470
Berlin,2022,49327,120710,-,650,170687
Berlin,2023,49825,121195,-,666,171686
Berlin,2024,49088,119690,-,671,169449
Brandenburg,2006,19902,61431,46272,937,128542
Brandenburg,2007,21013,61610,52309,563,135495
Brandenburg,2008,21623,62500,55288,575,139986
Brandenburg,2009,23530,62549,58093,332,144504
Brandenburg,2010,25171,62677,59855,275,147978
Brandenburg,2011,25673,63775,61742,312,151502
Brandenburg,2012,26410,65542,63409,260,155621
Brandenburg,2013,26777,66839,64988,299,158903
Brandenburg,2014,29078,68681,66045,399,164203
Brandenburg,2015,29462,69471,68460,179,167572
Brandenburg,2016,30524,70863,70992,213,172592
Brandenburg,2017,31395,71151,73865,350,176761
Brandenburg,2018,32269,72545,75892,277,180983
Brandenburg,2019,32907,74193,76280,260,183640
Brandenburg,2020,32855,77189,78382,439,188865
Brandenburg,2021,31798,78496,77913,463,188670
Brandenburg,2022,31562,79530,79544,545,191181
Brandenburg,2023,31816,79877,85651,535,197879
Brandenburg,2024,30812,78357,90412,501,200082
Bremen,2006,1198,16606,4043,39,21886
Bremen,2007,1404,16200,4048,30,21682
Bremen,2008,1723,15979,3704,43,21449
Bremen,2009,1846,16151,3656,44,21697
Bremen,2010,2125,16313,3660,29,22127
Bremen,2011,2564,16743,3530,16,22853
Bremen,2012,2737,16840,3484,21,23082
Bremen,2013,3062,16974,3459,21,23516
Bremen,2014,3620,17282,3228,19,24149
Bremen,2015,3865,17362,3194,37,24458
Bremen,2016,4120,17515,2989,40,24664
Bremen,2017,4304,18102,2731,119,25256
Bremen,2018,4860,18870,2983,108,26821
Bremen,2019,4906,19437,3075,29,27447
Bremen,2020,5102,19929,3055,32,28118
Bremen,2021,5193,20776,2955,63,28987
Bremen,2022,5347,21557,2556,90,29550
Bremen,2023,5416,22057,2504,80,30057
Bremen,2024,5189,22599,2409,127,30324
Hamburg,2006,7705,38126,13970,756,60557
Hamburg,2007,8286,39892,15925,399,64502
Hamburg,2008,8723,40091,17102,1313,67229
Hamburg,2009,10017,40415,18395,1203,70030
Hamburg,2010,11673,41690,19909,647,73919
Hamburg,2011,13753,43493,18157,543,75946
Hamburg,2012,15480,44575,19013,376,79444
Hamburg,2013,17266,45823,17398,313,80800
Hamburg,2014,19857,46923,5043,53,71876
Hamburg,2015,20945,47919,5050,163,74077
Hamburg,2016,21803,48201,5205,366,75575
Hamburg,2017,24153,50101,1687,51,75992
Hamburg,2018,24428,52527,1556,161,78672
Hamburg,2019,26442,53651,1557,35,81685
Hamburg,2020,26273,56137,1542,93,84045
Hamburg,2021,26369,56781,1646,34,84830
Hamburg,2022,27438,56842,1635,57,85972
Hamburg,2023,27685,57013,1605,52,86355
Hamburg,2024,26670,56626,2118,275,85689
Hessen,2006,12515,181955,25654,1455,221579
Hessen,2007,15759,181077,28187,805,225828
Hessen,2008,18297,178673,29174,757,226901
Hessen,2009,20487,177533,29675,924,228619
Hessen,2010,24602,175806,30349,1038,231795
Hessen,2011,27097,175878,30014,941,233930
Hessen,2012,29917,176032,30516,469,236934
Hessen,2013,32885,176564,30059,555,240063
Hessen,2014,37719,178468,28610,632,245429
Hessen,2015,40468,179272,28873,250,248863
Hessen,2016,42371,181695,27974,286,252326
Hessen,2017,44984,185382,27744,323,258433
Hessen,2018,46769,188602,26988,359,262718
Hessen,2019,48581,193989,25600,399,268569
Hessen,2020,48934,199453,24348,247,272982
Hessen,2021,47379,202456,22573,271,272679
Hessen,2022,49468,205147,22280,312,277207
Hessen,2023,50551,207380,21938,351,280220
Hessen,2024,50863,207081,21596,442,279982
Mecklenburg-Vorpommern,2006,12960,42398,22234,487,78079
Mecklenburg-Vorpommern,2007,12899,43067,25007,178,81151
Mecklenburg-Vorpommern,2008,12939,43216,27376,192,83723
Mecklenburg-Vorpommern,2009,14524,43327,28939,159,86949
Mecklenburg-Vorpommern,2010,15050,43660,30100,129,88939
Mecklenburg-Vorpommern,2011,15622,43926,31244,212,91004
Mecklenburg-Vorpommern,2012,16139,44623,32256,154,93172
Mecklenburg-Vorpommern,2013,16405,45517,32988,155,95065
Mecklenburg-Vorpommern,2014,16962,46654,33799,135,97550
Mecklenburg-Vorpommern,2015,17431,47047,34732,157,99367
Mecklenburg-Vorpommern,2016,18133,47335,35951,226,101645
Mecklenburg-Vorpommern,2017,18696,47491,37383,208,103778
Mecklenburg-Vorpommern,2018,19187,47856,38489,173,105705
Mecklenburg-Vorpommern,2019,19327,48462,39099,204,107092
Mecklenburg-Vorpommern,2020,19480,49198,40760,204,109642
Mecklenburg-Vorpommern,2021,19389,49358,42785,166,111698
Mecklenburg-Vorpommern,2022,19490,49153,44353,208,113204
Mecklenburg-Vorpommern,2023,19368,49220,46055,233,114876
Mecklenburg-Vorpommern,2024,18576,48354,47373,224,114527
Niedersachsen,2006,9406,229158,13162,1383,253109
Niedersachsen,2007,12283,231152,15557,1220,260212
Niedersachsen,2008,15140,230386,17187,948,263661
Niedersachsen,2009,18795,227878,19751,1095,267519
Niedersachsen,2010,23330,225159,21782,1250,271521
Niedersachsen,2011,27915,220546,23791,806,273058
Niedersachsen,2012,32094,215291,25991,776,274152
Niedersachsen,2013,35765,211860,27457,823,275905
Niedersachsen,2014,41286,211722,28923,736,282667
Niedersachsen,2015,43894,210885,30437,548,285764
Niedersachsen,2016,46314,212749,32119,386,291568
Niedersachsen,2017,50097,216809,33318,510,300734
Niedersachsen,2018,53082,221308,33716,468,308574
Niedersachsen,2019,56239,229379,33656,544,319818
Niedersachsen,2020,57616,239824,33618,645,331703
Niedersachsen,2021,56438,245605,31373,512,333928
Niedersachsen,2022,61095,251964,31465,511,345035
Niedersachsen,2023,64043,258126,31607,639,354415
Niedersachsen,2024,64853,260314,31670,959,357796
Nordrhein-Westfalen,2006,24925,517909,40988,1449,585271
Nordrhein-Westfalen,2007,23834,514239,30559,933,569565
Nordrhein-Westfalen,2008,32203,518069,17303,1234,568809
Nordrhein-Westfalen,2009,39376,508024,11686,698,559784
Nordrhein-Westfalen,2010,46140,493548,7944,550,548182
Nordrhein-Westfalen,2011,50724,488169,6362,517,545772
Nordrhein-Westfalen,2012,55697,478954,4923,527,540101
Nordrhein-Westfalen,2013,60624,476154,3857,554,541189
Nordrhein-Westfalen,2014,73999,476353,3539,373,554264
Nordrhein-Westfalen,2015,84831,476719,3786,125,565461
Nordrhein-Westfalen,2016,86925,483719,3360,143,574147
Nordrhein-Westfalen,2017,90918,490239,3533,148,584838
Nordrhein-Westfalen,2018,94620,500598,3568,165,598951
Nordrhein-Westfalen,2019,98458,513270,3103,216,615047
Nordrhein-Westfalen,2020,100653,527694,3013,440,631800
Nordrhein-Westfalen,2021,101851,539536,2826,541,644754
Nordrhein-Westfalen,2022,104477,546285,2715,566,654043
Nordrhein-Westfalen,2023,106486,551977,2453,732,661648
Nordrhein-Westfalen,2024,108615,551944,2500,762,663821
Rheinland-Pfalz,2006,8949,126627,7616,488,143680
Rheinland-Pfalz,2007,11150,122783,7943,425,142301
Rheinland-Pfalz,2008,13467,120010,8598,546,142621
Rheinland-Pfalz,2009,15588,114411,8666,450,139115
Rheinland-Pfalz,2010,17702,111693,8850,438,138683
Rheinland-Pfalz,2011,21731,111137,8898,342,142108
Rheinland-Pfalz,2012,23556,111018,8672,317,143563
Rheinland-Pfalz,2013,25017,111229,8518,302,145066
Rheinland-Pfalz,2014,27483,111657,8314,229,147683
Rheinland-Pfalz,2015,28393,111719,8294,203,148609
Rheinland-Pfalz,2016,29217,113993,8366,270,151846
Rheinland-Pfalz,2017,31238,116392,8306,179,156115
Rheinland-Pfalz,2018,32186,119001,8368,251,159806
Rheinland-Pfalz,2019,32979,122041,8336,354,163710
Rheinland-Pfalz,2020,32829,125835,8338,215,167217
Rheinland-Pfalz,2021,30501,127815,7805,226,166347
Rheinland-Pfalz,2022,32129,129214,7948,113,169404
Rheinland-Pfalz,2023,33419,130513,7615,307,171854
Rheinland-Pfalz,2024,33464,130683,7474,300,171921
Saarland,2006,2253,28504,2453,138,33348
Saarland,2007,2565,27198,2564,113,32440
Saarland,2008,2899,26420,2554,162,32035
Saarland,2009,2984,25887,2291,135,31297
Saarland,2010,3444,25398,1882,76,30800
Saarland,2011,3899,25209,2059,84,31251
Saarland,2012,4195,24802,2012,115,31124
Saarland,2013,4666,25009,2159,127,31961
Saarland,2014,5152,24942,2118,58,32270
Saarland,2015,5557,25067,2251,109,32984
Saarland,2016,5923,25595,2529,101,34148
Saarland,2017,6244,25739,2866,90,34939
Saarland,2018,6425,26126,2353,155,35059
Saarland,2019,6800,26593,2438,57,35888
Saarland,2020,6584,27124,2539,100,36347
Saarland,2021,6600,27340,2403,88,36431
Saarland,2022,7101,27464,2381,138,37084
Saarland,2023,7379,28003,2525,139,38046
Saarland,2024,7363,28222,2655,169,38409
Sachsen,2006,30632,108297,75092,340,214361
Sachsen,2007,31182,109840,83290,513,224825
Sachsen,2008,32644,111376,91136,581,235737
Sachsen,2009,35929,112674,95617,633,244853
Sachsen,2010,38593,114518,99076,671,252858
Sachsen,2011,40220,115883,102320,612,259035
Sachsen,2012,42408,118123,105584,608,266723
Sachsen,2013,42909,120779,108423,675,272786
Sachsen,2014,45207,123903,111921,602,281633
Sachsen,2015,46867,125551,115200,666,288284
Sachsen,2016,48462,127628,119346,734,296170
Sachsen,2017,49837,129237,124300,804,304178
Sachsen,2018,50203,131154,128281,899,310537
Sachsen,2019,50905,132206,130843,921,314875
Sachsen,2020,50036,134593,133657,621,318907
Sachsen,2021,48314,134434,132848,857,316453
Sachsen,2022,48126,133418,135228,1209,317981
Sachsen,2023,47967,132808,141075,904,322754
Sachsen,2024,45349,128812,144306,951,319418
Sachsen-Anhalt,2006,25568,59164,31072,264,116068
Sachsen-Anhalt,2007,26309,58739,34934,115,120097
Sachsen-Anhalt,2008,26722,58500,38445,203,123870
Sachsen-Anhalt,2009,28234,58009,41168,225,127636
Sachsen-Anhalt,2010,28815,58343,42356,163,129677
Sachsen-Anhalt,2011,28876,58941,43657,141,131615
Sachsen-Anhalt,2012,29080,59676,45648,184,134588
Sachsen-Anhalt,2013,29064,60468,46940,211,136683
Sachsen-Anhalt,2014,29115,61120,47576,191,138002
Sachsen-Anhalt,2015,29216,61186,49157,198,139757
Sachsen-Anhalt,2016,29702,61431,50934,253,142320
Sachsen-Anhalt,2017,30302,61929,53534,223,145988
Sachsen-Anhalt,2018,30516,62670,55387,216,148789
Sachsen-Anhalt,2019,30779,63434,56177,210,150600
Sachsen-Anhalt,2020,29950,64282,56749,253,151234
Sachsen-Anhalt,2021,28196,64489,57130,274,150089
Sachsen-Anhalt,2022,28335,64180,59097,309,151921
Sachsen-Anhalt,2023,28075,64496,61773,281,154625
Sachsen-Anhalt,2024,26559,63230,64085,346,154220
Schleswig-Holstein,2006,4263,79833,6578,387,91061
Schleswig-Holstein,2007,4310,79988,7232,760,92290
Schleswig-Holstein,2008,5133,78649,7049,1440,92271
Schleswig-Holstein,2009,6329,77714,7669,1728,93440
Schleswig-Holstein,2010,7997,77169,8407,765,94338
Schleswig-Holstein,2011,10197,78054,7870,319,96440
Schleswig-Holstein,2012,11425,78337,7954,261,97977
Schleswig-Holstein,2013,12655,78555,8480,546,100236
Schleswig-Holstein,2014,14961,78797,8349,305,102412
Schleswig-Holstein,2015,16670,78932,8366,371,104339
Schleswig-Holstein,2016,17029,79937,8774,820,106560
Schleswig-Holstein,2017,18076,81273,9494,346,109189
Schleswig-Holstein,2018,19553,82030,9358,334,111275
Schleswig-Holstein,2019,20448,83717,9298,285,113748
Schleswig-Holstein,2020,20569,85301,9663,302,115835
Schleswig-Holstein,2021,20518,86169,9844,168,116699
Schleswig-Holstein,2022,21603,87485,9900,161,119149
Schleswig-Holstein,2023,22730,89135,9085,258,121208
Schleswig-Holstein,2024,22938,88686,9432,373,121429
Thüringen,2006,18697,58855,1654,248,79454
Thüringen,2007,18216,58938,1734,242,79130
Thüringen,2008,18823,58705,1681,251,79460
Thüringen,2009,20930,58208,1711,244,81093
Thüringen,2010,22315,57988,1582,217,82102
Thüringen,2011,23439,58458,1335,189,83421
Thüringen,2012,24800,59116,1201,181,85298
Thüringen,2013,25898,60148,1083,201,87330
Thüringen,2014,26340,61338,924,182,88784
Thüringen,2015,26856,61712,816,181,89565
Thüringen,2016,27519,62695,734,190,91138
Thüringen,2017,28294,63955,566,191,93006
Thüringen,2018,28776,64595,474,210,94055
Thüringen,2019,28662,65349,414,234,94659
Thüringen,2020,27789,65989,411,254,94443
Thüringen,2021,26113,65434,321,311,92179
Thüringen,2022,25886,64376,371,295,90928
Thüringen,2023,25396,63778,339,324,89837
Thüringen,2024,23983,61912,337,303,86535
Länder insgesamt,2006,253884,2331776,356144,12179,2953983
Länder insgesamt,2007,278642,2311790,383476,8085,2981993
Länder insgesamt,2008,313114,2294890,399737,10155,3017897
Länder insgesamt,2009,356274,2266641,417779,10222,3050916
Länder insgesamt,2010,400336,2238480,431539,8546,3078901
Länder insgesamt,2011,437390,2238118,439922,7270,3122700
Länder insgesamt,2012,472176,2233171,452073,6179,3163599
Länder insgesamt,2013,503926,2242276,460553,6410,3213165
Länder insgesamt,2014,561569,2263451,453973,6133,3285126
Länder insgesamt,2015,593639,2275306,468034,4807,3341786
Länder insgesamt,2016,614600,2312214,480383,6356,3413553
Länder insgesamt,2017,645077,2354261,494673,5195,3499206
Länder insgesamt,2018,665302,2404402,502205,5686,3577595
Länder insgesamt,2019,687427,2464737,504725,6455,3663344
Länder insgesamt,2020,695048,2538861,512774,5739,3752422
Länder insgesamt,2021,680502,2586471,505375,5507,3777855
Länder insgesamt,2022,705793,2625257,516327,6209,3853586
Länder insgesamt,2023,721551,2662913,534506,7453,3926423
Länder insgesamt,2024,717248,2661244,550373,8265,3937130
